200 10
                      |
 P--      P--      1  |
 Q--Q--   Q--         |
2       3 Q--         |
       Q--            |
        3 Q--         |
        Q--           |
      3               |
Q-Q-Q-Q-Q-Q-Q-Q-Q-Q-Q--Q|
------------------------|